1111111111111111111111111111111111
1E0000000000000C00000C000000000001
1010010100100000101001000000010101
1010010010001010001001000000010101
1010010010101010101001000000010101
1010000010101010001001000000010101
1P0000000C00C0000001000000000000C1
1010000000100001001001000000010101
1010010000000000101001000000010101
1111111111111111111111111111111111
