111111111111111111111111111111111111
100000000000000C00000C00000000000111
101001010010000010100100000001010111
101001001000101000100100000001010111
101001001010101010100100000001010111
1E1000001010101000111111111111010001
111111111C00C00000010000000000000101
101000000010000100100100100001010101
1P1001000111111110100100100001010101
100000000000000C00000C00100000000101
101001010010000010100111100001010101
1010010010001010001001001000010101C1
101001001010101010100100100001010111
101000001010101000100100100001010111
100000000C00C0000001000000000000C111
101000000010000100100100000001010111
111111111111111111111111111111111111
